Detector,Profile,File,Threshold,Score,TP,TN,FP,FN,Total_Count
kent,reward_low_FP_rate,realTweets/Twitter_volume_AMZN.csv,0.523386545401,-1.23706566172,7,13496,5,1573,15081
kent,reward_low_FP_rate,realAdExchange/exchange-4_cpc_results.csv,0.523386545401,0.512263690746,3,1231,1,162,1397
kent,reward_low_FP_rate,realAWSCloudwatch/ec2_cpu_utilization_fe7f93.csv,0.523386545401,0.739634634561,2,3023,0,403,3428
kent,reward_low_FP_rate,artificialWithAnomaly/art_daily_nojump.csv,0.523386545401,-1.55670293184,0,3022,3,403,3428
kent,reward_low_FP_rate,realKnownCause/cpu_utilization_asg_misconfiguration.csv,0.523386545401,-1.89320103313,19,15788,13,1480,17300
kent,reward_low_FP_rate,realAWSCloudwatch/grok_asg_anomaly.csv,0.523386545401,1.34952341776,8,3456,7,457,3928
kent,reward_low_FP_rate,artificialNoAnomaly/art_noisy.csv,0.523386545401,0.0,0,3428,0,0,3428
kent,reward_low_FP_rate,realTweets/Twitter_volume_IBM.csv,0.523386545401,-2.36958961576,5,13533,20,1585,15143
kent,reward_low_FP_rate,realKnownCause/ec2_request_latency_system_failure.csv,0.523386545401,1.37586905384,7,3079,3,339,3428
kent,reward_low_FP_rate,realTweets/Twitter_volume_PFE.csv,0.523386545401,2.47177643559,8,13515,5,1580,15108
kent,reward_low_FP_rate,realAWSCloudwatch/rds_cpu_utilization_cc0c53.csv,0.523386545401,-0.138449197924,2,3026,0,400,3428
kent,reward_low_FP_rate,realAWSCloudwatch/ec2_cpu_utilization_ac20cd.csv,0.523386545401,0.875727409493,3,3025,0,400,3428
kent,reward_low_FP_rate,realKnownCause/ambient_temperature_system_failure.csv,0.523386545401,0.656227089594,4,5786,5,722,6517
kent,reward_low_FP_rate,realTweets/Twitter_volume_FB.csv,0.523386545401,1.50048222172,3,13500,1,1579,15083
kent,reward_low_FP_rate,artificialNoAnomaly/art_daily_perfect_square_wave.csv,0.523386545401,0.0,0,3428,0,0,3428
kent,reward_low_FP_rate,realTweets/Twitter_volume_UPS.csv,0.523386545401,1.43229229244,17,13526,5,1568,15116
kent,reward_low_FP_rate,realTraffic/speed_7578.csv,0.523386545401,2.42717125146,5,837,5,111,958
kent,reward_low_FP_rate,artificialWithAnomaly/art_increase_spike_density.csv,0.523386545401,0.86067182427,1,3025,0,402,3428
kent,reward_low_FP_rate,artificialNoAnomaly/art_daily_small_noise.csv,0.523386545401,-0.44,0,3426,2,0,3428
kent,reward_low_FP_rate,artificialWithAnomaly/art_daily_jumpsup.csv,0.523386545401,0.86067182427,4,3025,0,399,3428
kent,reward_low_FP_rate,realTraffic/TravelTime_387.csv,0.523386545401,-0.0534047180653,2,1873,3,247,2125
kent,reward_low_FP_rate,realTraffic/TravelTime_451.csv,0.523386545401,0.560099568244,1,1621,0,216,1838
kent,reward_low_FP_rate,artificialNoAnomaly/art_flatline.csv,0.523386545401,0.0,0,3428,0,0,3428
kent,reward_low_FP_rate,realKnownCause/machine_temperature_system_failure.csv,0.523386545401,0.422852509647,6,19672,5,2262,21945
kent,reward_low_FP_rate,realAdExchange/exchange-4_cpm_results.csv,0.523386545401,1.16471036268,5,1231,2,159,1397
kent,reward_low_FP_rate,realAdExchange/exchange-2_cpc_results.csv,0.523386545401,-1.66,0,1215,3,163,1381
kent,reward_low_FP_rate,realAWSCloudwatch/ec2_cpu_utilization_77c1ca.csv,0.523386545401,0.481473301883,3,3021,4,400,3428
kent,reward_low_FP_rate,realAWSCloudwatch/rds_cpu_utilization_e47b3b.csv,0.523386545401,1.71226928014,3,3026,0,399,3428
kent,reward_low_FP_rate,realAWSCloudwatch/ec2_cpu_utilization_53ea38.csv,0.523386545401,0.656833041796,3,3025,1,399,3428
kent,reward_low_FP_rate,realAdExchange/exchange-3_cpc_results.csv,0.523386545401,2.5707776045,3,1155,0,150,1308
kent,reward_low_FP_rate,artificialNoAnomaly/art_daily_no_noise.csv,0.523386545401,-0.66,0,3425,3,0,3428
kent,reward_low_FP_rate,realAWSCloudwatch/ec2_network_in_5abac7.csv,0.523386545401,1.10157140283,4,3544,3,470,4021
kent,reward_low_FP_rate,realTweets/Twitter_volume_AAPL.csv,0.523386545401,0.709733737974,11,13558,6,1577,15152
kent,reward_low_FP_rate,realAWSCloudwatch/ec2_network_in_257a54.csv,0.523386545401,0.86067182427,4,3025,0,399,3428
kent,reward_low_FP_rate,realTraffic/occupancy_t4013.csv,0.523386545401,1.5160251845,4,1874,1,246,2125
kent,reward_low_FP_rate,realTweets/Twitter_volume_KO.csv,0.523386545401,2.24288614785,6,13512,2,1581,15101
kent,reward_low_FP_rate,artificialWithAnomaly/art_load_balancer_spikes.csv,0.523386545401,0.294788146524,6,3022,3,397,3428
kent,reward_low_FP_rate,realAWSCloudwatch/elb_request_count_8c0756.csv,0.523386545401,1.49595613499,4,3025,1,398,3428
kent,reward_low_FP_rate,realTraffic/speed_6005.csv,0.523386545401,0.182622001756,3,1883,3,236,2125
kent,reward_low_FP_rate,realAWSCloudwatch/ec2_cpu_utilization_5f5533.csv,0.523386545401,1.72310160415,6,3026,0,396,3428
kent,reward_low_FP_rate,realAWSCloudwatch/iio_us-east-1_i-a2eb1cd9_NetworkIn.csv,0.523386545401,-2.22,0,930,1,126,1057
kent,reward_low_FP_rate,realAdExchange/exchange-3_cpm_results.csv,0.523386545401,0.642220519336,2,1154,1,151,1308
kent,reward_low_FP_rate,realKnownCause/rogue_agent_key_hold.csv,0.523386545401,-1.33370102385,1,1408,2,189,1600
kent,reward_low_FP_rate,realKnownCause/nyc_taxi.csv,0.523386545401,2.32807388255,8,8534,1,1027,9570
kent,reward_low_FP_rate,realAdExchange/exchange-2_cpm_results.csv,0.523386545401,1.28824330604,3,1217,2,159,1381
kent,reward_low_FP_rate,realTweets/Twitter_volume_GOOG.csv,0.523386545401,-0.920195914837,8,13652,8,1424,15092
kent,reward_low_FP_rate,realTraffic/occupancy_6005.csv,0.523386545401,0.861272490375,2,1784,0,237,2023
kent,reward_low_FP_rate,realAWSCloudwatch/ec2_cpu_utilization_24ae8d.csv,0.523386545401,0.839566484907,3,3022,4,399,3428
kent,reward_low_FP_rate,artificialWithAnomaly/art_daily_flatmiddle.csv,0.523386545401,0.453090365817,1,3023,2,402,3428
kent,reward_low_FP_rate,realTweets/Twitter_volume_CRM.csv,0.523386545401,0.723575559502,5,13559,0,1588,15152
kent,reward_low_FP_rate,realAWSCloudwatch/ec2_disk_write_bytes_1ef3de.csv,0.523386545401,0.296299992988,3,3545,3,470,4021
kent,reward_low_FP_rate,realTraffic/speed_t4013.csv,0.523386545401,1.98462491465,7,1871,0,243,2121
kent,reward_low_FP_rate,realTweets/Twitter_volume_CVS.csv,0.523386545401,1.87550622489,9,13573,4,1517,15103
kent,reward_low_FP_rate,artificialWithAnomaly/art_daily_jumpsdown.csv,0.523386545401,0.418908670438,4,3023,2,399,3428
kent,reward_low_FP_rate,realAWSCloudwatch/ec2_cpu_utilization_825cc2.csv,0.523386545401,0.736537840284,8,3084,1,335,3428
kent,reward_low_FP_rate,realAWSCloudwatch/ec2_disk_write_bytes_c0d644.csv,0.523386545401,0.337302738031,6,3021,2,399,3428
kent,reward_low_FP_rate,realKnownCause/rogue_agent_key_updown.csv,0.523386545401,-1.96511219487,1,4028,7,529,4565
kent,reward_low_FP_rate,realAWSCloudwatch/ec2_cpu_utilization_c6585a.csv,0.523386545401,-0.66,0,3425,3,0,3428
Totals,,,,28.4364836973,243,299189,158,33252,332842
